1111111111111111111111
1C000000000000000000P1
1000011100111011100101
101C000000000000000C01
1010101100011011100101
10000E0000000000000101
1010001110011011010101
101C000000100000000C01
1000111000110011001101
1C000000000000000000C1
1111111111111111111111
